{
	"meta": {
        "tileGap": 0,
        "width": 12,
        "height": 7
    },
    "layout": [
        0, 0, 0, 0,20,20, 0, 0, 0, 0, 0, 0,
           0, 1, 0, 0,20, 0, 0, 0, 0, 0, 0, 0,
              0, 0, 0,20, 0, 0, 0, 0, 0,20, 0, 0,
                 0,10, 0,20, 0,10, 0,10, 0,20, 0,10,
                    0, 0,20, 0, 0, 0, 0, 0,20, 0, 0, 0,
                       0, 0, 0, 0, 0, 1, 0, 0,20, 0, 0, 0,
                          0, 0, 0, 0, 0, 0, 0,20,20, 0, 0, 0
    ]
}